{
    "moves": 3,
    "targetScore": 400,
    "gemValue": 10,
    "size": {
        "x": 7,
        "y": 7
    },
    "boardGems": [
        1,  3,  2,  1,  1,  5,  1,
        3,  4,  1,  5,  1,  2,  2,
        1,  2,  3,  5,  3,  1,  1,
        2,  1,  2,  1,  1,  4,  2,
        2,  5,  3,  2,  4,  1,  3,
        5,  4,  1,  4,  3,  5,  4,
        4,  1,  2,  5,  2,  1,  5
    ]
}